S...X..........
.X..X..XXXX....
.X.....X.......
.XXX.X.X.XX....
.....X.X.......
XXX..X.XXX..X..
....XX.....X...
..X....XXX.....
..X.XX.....X...
..X....X.......
.XXXX..X.XXXX..
......X.....X..
.X.XX.XXX...X..
....X.....X....
.XX...XXX.....G